コンビ名	山田	大吉	塙	富澤	立川	礼二	松本	合計
カベポスター	84	94	92	93	89	92	90	634
真空ジェシカ	95	92	92	92	94	94	88	647
オズワルド	87	93	90	90	95	92	92	639
ロングコートダディ	94	92	94	96	96	95	93	660
さや香	92	96	95	97	95	97	95	667
男性ブランコ	86	91	92	95	94	96	96	650
ダイヤモンド	86	90	88	88	88	89	87	616
ヨネダ2000	91	91	96	91	97	90	91	647
キュウ	87	90	88	90	89	90	86	620
ウエストランド	91	93	93	94	98	96	94	659